Start ######
           #   ####
           #####  #
                  #
                  #
                  #
######            #
#    #            #
#    #            #
#    ##############
#
#             ####
#             #  #
#   ####    ###  ###
#   #  #    #      #
#####  ######      ##
                    #
          ########  #
          #      #  #
          #      #  #
  #####   #      ####
  #   #   #
  #   #   #
  #   #####
  #
  #
  ########################  End
